1111111111111111111
1000000E00000000001
1010000000000E00001
1000000000001000001
10000010000P000C001
1000000000001000001
1111111111111111111