1111111111111111111111111
100P000010000000000000001
1000000011000001010000001
100000001000000E1C1000001
1000000010000001000000001
1000000010000000010000001
1000000000000000001000001
1111111111111111111111111