1111111111111111
1C0010C0000E00C1
1000000P00010101
1111111111111111