11111111111111111111111111111
11111P10001000100001000001101
10000000001100000101000100001
10010000001000000E1C100000001
10000000000001000100000001101
10000011111000000001000001101
10000X00000000111111101100001
11111111111111111111111111111